   WE                            textures/west.png
NO      textures/north.png



SO textures/south.png

F      17,    38,     64

EA textures/east.png


C 218, 234, 235

111111111111111111
1000000000000001111
10000000000001111111
100000000000000001111
1000000000000000001111
100000000000000000S1111
1000000000000000001111
100000000000000001111
10000000000000001111
1000000000000001111
111111111111111111
