NO textures/wall_1.xpm
SO textures/wall_2.xpm
EA textures/wall_3.xpm
WE textures/wall_4.xpm
F 220,100,0
C 225,30,0
   
1111111111111111
1000000110000001
1001000000000001
1000000000010001
1000000000011111
1000000000000001
1110000000000001
1000000000011001
1000000000000001
1001100000000001
1000000000110001
1000000000100001
10011110001000W1
1111111111111111
